###############
#***...R......#
#***... ...*..#
#\\\!.. ..\\\.#
#...... ...*..#
#..     .. ...#
#.... .... ...#
#.... .... ...#
#.. .   !   ..#
#..*. .. . ...#
#.... .. . ...#
#.\.. .... ..*#
#......... . .#
#........ W   #
#############L#

Growth 25
Razors 1
